
        NO textures/simonkraft/bookshelf.xpm
           WE textures/simonkraft/bookshelf_03.xpm

    EA textures/simonkraft/bookshelf_03.xpm 
 SO textures/simonkraft/bookshelf_01.xpm

                      F 139           ,99             ,       58
    C      171,      154,      137


1111111111111111111
1001000100100100111
1001001001001001001
1001001001001001001

1001001000001001001

100000000S000000001
1000011111111000001

1111000000000001111
1000000101010000001
1111111111111111111
