
NO ./textures/north.xpm
SO ./textures/south.xpm
WE ./textures/west.xpm
EA ./textures/east.xpm



C 35,19,73
F 15,6,40



1111111111 111111111111111
1000000000110000000000001
1011000001110000000000001
1001000000000000000000001
1111111110110000 01110000000000001
100000000011000001110111111111111
11110011111111011100000010001
11110011111111011101010010001
11000 000110101011100000010001
10000000000000001100000010001
100000000 0000001101010010001
1101N1011101010111110111100111
11111111111110101101111010001
11111111111111111 111111111111




1111
1001
1001
1111