NO ./a
SO ./b
WE ./c
EA ./d

F 10,10,10
C 200,200,200

111111111
1N0010001
100000001
100001001
100000001
100100001
100000001
100001001
100001001
100001001
100000001
100000001
111111111
